###########################
A    ##### ####       #####
#### ##### #### ###########
##                    #####
## ########################
#  ########################
# ## ############# ########
# ## #                 ####
# ## ############### ######
#                       ###
######################    #
#                       ###
## ################## #####
#  #                   ####
# ## ############# ########
# ## ############# ########
# ## #       #        #####
# ## #### ########## ######
# ## ##               #####
####################B######